0 0 0 0 0 0 0 0 0 0 0 0 0 0 0 0 0 0 0 0 0 0 0 0 0 0 0 0 0 0 0 0 0 0 0 0 0 0 0 0 0 0 0 0 0 0 0 0 0 0 
0 0 0 0 0 0 0 0 0 0 0 0 0 0 11 11 3 11 11 0 0 0 0 0 0 0 0 0 0 0 0 0 0 0 0 0 0 0 0 0 0 0 0 0 0 0 0 0 0 0 
0 0 0 0 0 0 0 0 0 0 0 0 0 0 11 11 3 11 11 0 0 0 0 0 0 0 0 0 0 0 0 0 0 0 0 0 0 0 0 0 0 0 0 0 0 0 0 0 0 0 
0 0 0 0 0 0 0 0 0 0 0 0 0 0 11 9 3 9 11 0 0 0 0 0 0 0 0 0 0 0 0 0 0 0 0 0 0 0 0 0 0 0 0 0 0 0 0 0 0 0 
0 11 9 9 9 9 9 9 9 9 9 9 9 9 9 10 2 10 9 9 9 9 9 9 9 9 9 9 9 9 9 11 0 0 0 0 0 0 0 0 0 0 0 0 0 0 0 0 0 0 
0 11 10 10 10 10 10 10 10 10 10 10 10 10 10 2 2 2 10 10 10 10 10 10 10 10 10 10 10 10 10 11 0 0 0 0 0 0 0 0 0 0 0 0 0 0 0 0 0 0 
0 11 1 4 4 1 4 1 4 1 4 1 4 1 4 1 4 1 4 1 4 1 4 1 4 1 4 1 4 1 4 11 0 0 0 0 0 0 0 0 0 0 0 0 0 0 0 0 0 0 
0 11 1 4 4 1 4 1 4 1 4 1 4 1 4 1 4 1 4 1 4 1 4 1 4 1 4 1 4 1 4 11 0 0 0 0 0 0 0 0 0 0 0 0 0 0 0 0 0 0 
0 11 1 4 4 1 4 1 4 1 4 1 4 1 4 1 4 1 4 1 4 1 4 1 4 1 4 1 4 1 4 11 0 0 0 0 0 0 0 0 0 0 0 0 0 0 0 0 0 0 
0 11 1 4 4 1 4 1 4 1 4 1 4 1 4 1 4 1 4 1 4 1 4 1 4 1 4 1 4 1 4 11 0 0 0 0 0 0 0 0 0 0 0 0 0 0 0 0 0 0 
0 11 1 4 4 1 4 1 4 1 4 1 4 1 4 1 4 1 4 1 4 1 4 1 4 1 4 1 4 9 9 11 0 0 0 0 0 0 0 0 0 0 0 0 0 0 0 0 0 0 
0 11 1 4 4 1 4 1 4 1 4 1 4 1 4 1 4 1 4 1 4 1 4 1 4 1 4 1 4 10 10 11 0 0 0 0 0 0 0 0 0 0 0 0 0 0 0 0 0 0 
0 11 11 9 9 1 4 1 4 1 4 1 4 1 4 1 4 1 4 1 4 1 4 1 4 1 4 1 4 1 4 11 0 0 0 0 0 0 0 0 0 0 0 0 0 0 0 0 0 0 
0 10 11 10 10 1 4 1 4 1 4 1 4 1 4 1 4 1 4 1 4 1 4 1 4 1 4 1 4 1 4 11 0 0 0 0 0 0 0 0 0 0 0 0 0 0 0 0 0 0 
0 0 11 1 4 1 4 1 4 1 4 1 4 1 4 1 4 1 4 1 4 1 4 1 4 1 4 1 4 1 4 11 0 0 0 0 0 0 0 0 0 0 0 0 0 0 0 0 0 0 
0 0 11 1 4 1 4 1 4 1 4 1 4 1 4 1 4 1 4 1 4 1 4 1 4 1 4 1 4 1 4 9 9 11 0 0 0 0 0 0 0 0 0 0 0 0 0 0 0 0 
0 0 11 1 4 1 4 1 4 1 4 1 4 1 4 1 4 1 4 1 4 1 4 1 4 1 4 1 4 1 4 10 10 11 0 0 0 0 0 0 0 0 0 0 0 0 0 0 0 0 
0 0 11 1 4 1 4 1 4 1 4 1 4 1 4 1 4 1 4 1 4 1 4 1 4 1 4 1 4 1 4 1 4 11 0 0 0 0 0 0 0 0 0 0 0 0 0 0 0 0 
0 0 11 1 4 1 4 1 4 1 4 1 4 1 4 1 4 1 4 1 4 1 4 1 4 1 4 1 4 11 4 1 4 11 0 0 0 0 0 0 0 0 0 0 0 0 0 0 0 0 
0 0 11 1 4 1 11 1 4 1 11 1 4 1 4 1 4 1 4 1 4 1 4 1 4 1 4 1 4 11 4 1 4 11 0 0 0 0 0 0 0 0 0 0 0 0 0 0 0 0 
0 0 11 1 4 1 11 1 4 1 11 1 4 1 4 1 4 1 4 1 4 1 4 1 4 11 9 9 9 9 9 9 9 11 0 0 0 0 0 0 0 0 0 0 0 0 0 0 0 0 
0 0 11 1 4 1 9 9 9 9 9 1 4 1 4 1 4 1 4 1 4 1 4 1 4 11 10 10 10 10 10 10 10 11 0 0 0 0 0 0 0 0 0 0 0 0 0 0 0 0 
0 0 11 1 4 1 10 10 10 10 10 1 4 9 9 11 4 1 11 9 9 1 4 1 4 11 4 1 4 1 4 1 4 11 0 0 0 0 0 0 0 0 0 0 0 0 0 0 0 0 
0 0 11 1 4 1 4 1 4 1 1 1 4 10 10 11 4 1 11 10 10 1 4 1 4 11 4 1 4 1 4 1 4 11 0 0 0 0 0 0 0 0 0 0 0 0 0 0 0 0 
0 0 11 1 4 1 4 1 4 1 1 1 4 1 4 9 9 9 9 1 4 1 4 1 4 11 4 1 4 1 4 1 4 11 0 0 0 0 0 0 0 0 0 0 0 0 0 0 0 0 
0 0 11 1 4 1 4 1 4 1 1 1 4 1 4 10 10 10 10 1 4 1 4 1 4 11 4 1 4 11 9 1 9 9 11 0 0 0 0 0 0 0 0 0 0 0 0 0 0 0 
0 5 9 9 9 9 9 11 4 1 4 1 4 4 1 4 1 4 4 4 4 1 4 1 4 1 4 1 4 11 10 1 10 10 11 0 0 0 0 0 0 0 0 0 0 0 0 0 0 0 
0 5 10 10 10 10 10 11 4 1 4 1 4 1 4 11 1 4 11 1 4 1 4 1 4 1 4 1 4 11 1 4 1 4 11 0 0 0 0 0 0 0 0 0 0 0 0 0 0 0 
0 5 4 1 4 1 4 9 9 9 9 9 9 1 4 11 1 4 11 1 4 1 4 1 4 1 4 1 4 11 1 4 1 4 11 0 0 0 0 0 0 0 0 0 0 0 0 0 0 0 
0 5 4 1 4 1 4 10 10 10 10 10 10 1 4 11 1 4 11 1 4 11 9 9 9 9 9 9 9 9 1 4 1 4 11 0 0 0 0 0 0 0 0 0 0 0 0 0 0 0 
0 5 4 1 4 1 4 1 4 1 4 1 4 1 4 11 1 4 11 1 4 11 10 10 10 10 10 10 10 10 1 4 1 4 11 0 0 0 0 0 0 0 0 0 0 0 0 0 0 0 
0 5 4 1 4 1 4 1 4 1 4 1 4 1 4 11 1 4 11 1 4 11 4 1 3 1 3 1 3 4 1 4 1 4 11 0 0 0 0 0 0 0 0 0 0 0 0 0 0 0 
0 5 9 9 9 9 9 9 9 9 9 9 9 9 9 9 9 9 9 9 9 9 4 1 3 1 3 1 3 4 1 4 1 4 11 0 0 0 0 0 0 0 0 0 0 0 0 0 0 0 
0 5 10 10 10 10 10 10 10 10 10 10 10 10 10 10 10 10 10 10 10 10 4 1 9 9 9 9 3 4 1 4 1 4 11 0 0 0 0 0 0 0 0 0 0 0 0 0 0 0 
0 5 4 1 4 1 4 1 4 1 1 4 1 4 1 4 1 4 1 4 1 1 4 1 10 10 10 10 3 4 1 4 1 4 11 0 0 0 0 0 0 0 0 0 0 0 0 0 0 0 
0 5 4 1 4 1 4 1 4 1 1 4 1 4 4 4 1 4 1 4 1 1 4 1 3 1 3 1 3 4 1 4 1 4 11 0 0 0 0 0 0 0 0 0 0 0 0 0 0 0 
0 5 4 9 9 9 9 11 9 9 9 9 9 9 9 9 9 9 11 1 4 1 4 1 3 1 3 11 9 9 9 9 9 9 9 9 9 9 6 0 0 0 0 0 0 0 0 0 0 0 
0 5 4 10 10 10 10 11 10 10 10 10 10 10 10 10 10 10 11 1 4 1 4 1 3 1 3 11 10 10 10 10 10 10 10 10 10 10 6 0 0 0 0 0 0 0 0 0 0 0 
0 5 4 1 4 1 4 11 4 1 4 1 4 1 4 1 1 4 11 1 4 9 9 9 9 9 9 9 1 4 1 4 1 4 1 4 1 4 6 0 0 0 0 0 0 0 0 0 0 0 
0 5 4 1 4 1 4 11 4 1 9 9 4 1 11 1 1 4 11 1 4 10 10 10 10 10 10 10 1 4 1 4 1 4 1 4 1 4 6 0 0 0 0 0 0 0 0 0 0 0 
0 5 4 1 9 9 9 9 4 1 10 10 4 1 11 1 1 4 11 1 4 1 4 1 4 1 4 4 1 4 1 4 1 4 1 4 1 4 6 0 0 0 0 0 0 0 0 0 0 0 
0 5 4 1 10 10 10 10 4 1 4 1 4 1 11 9 9 9 9 1 4 1 4 9 9 9 9 4 1 4 1 4 1 4 9 9 9 9 9 9 9 9 11 0 0 0 0 0 0 0 
0 5 4 1 4 1 4 1 4 1 4 1 4 1 11 10 10 10 10 1 4 1 4 10 10 10 10 4 1 4 1 4 1 4 10 10 10 10 10 10 10 10 11 0 0 0 0 0 0 0 
0 5 4 1 11 9 9 9 4 1 4 1 9 9 9 1 4 1 4 1 4 1 4 1 4 1 4 4 1 4 1 4 1 4 1 4 1 4 1 4 1 4 11 0 0 0 0 0 0 0 
0 5 4 1 11 10 10 10 4 1 4 1 10 10 10 1 4 1 4 1 4 1 4 1 9 9 9 9 9 4 1 4 1 9 9 9 9 4 1 4 1 4 11 0 0 0 0 0 0 0 
0 5 4 1 11 1 4 1 4 1 11 1 4 1 4 1 4 1 4 1 4 1 4 1 10 10 10 10 10 4 1 4 1 10 10 10 10 4 1 4 1 4 11 0 0 0 0 0 0 0 
0 8 16 2 11 1 4 1 4 1 11 1 4 1 4 1 4 1 4 1 4 1 4 1 4 1 4 4 4 1 1 1 1 4 1 4 1 4 1 4 1 4 11 0 0 0 0 0 0 0 
0 0 5 2 9 9 9 9 9 9 9 9 9 9 9 9 9 9 9 9 9 9 9 9 9 9 9 9 9 9 9 9 9 9 9 9 9 9 9 9 9 9 9 0 0 0 0 0 0 0 
0 0 8 7 7 7 7 7 7 7 7 7 7 7 7 7 7 7 7 7 7 7 7 7 7 7 7 7 7 7 7 7 7 7 7 7 7 7 7 7 7 7 7 0 0 0 0 0 0 0 
0 0 0 0 0 0 0 0 0 0 0 0 0 0 0 0 0 0 0 0 0 0 0 0 0 0 0 0 0 0 0 0 0 0 0 0 0 0 0 0 0 0 0 0 0 0 0 0 0 0 
